10
A.-.-.G.-.G.-.-.-.-
-.G.-.-.-.-.-.-.S.-
-.-.-.-.B.-.-.S.W.S
S.-.-.B.P.B.-.-.S.S
W.S.-.-.B.G.-.-.S.W
S.W.S.-.-.B.B.-.S.S
-.S.S.B.P.P.BSG.W.S
-.S.W.SG.-.B.B.G.SG.-
-.-.S.-.-.-.-.-.G.-
-.-.-.G.-.G.-.-.-.-