10
-.-.-.-.-.-.G.-.-.-
-.G.-.-.-.-.G.-.BG.-
G.-.-.G.-.-.-.BG.P.B
-.-.-.S.-.B.-.-.B.-
-.-.-.S.-.BG.-.-.-.-
-.G.-.-.-.-.-.BG.-.-
-.-.-.A.-.-.B.P.B.-
-.G.-.-.SG.-.-.B.G.-
-.-.-.S.Ư.SG.-.-.G.-