10
P.B.-.-.-.-.-.S.-.-
BG.P.B.-.G.-.S.W.S.G
-.B.P.B.-.-.-.S.-.-
-.-.B.-.G.-.G.-.-.G
-.S.-.G.-.G.-.-.S.-
S.W.S.-.A.-.-.S.W.S
G.S.-.G.-.G.-.B.S.-
-.-.S.-.-.-.B.P.B.-
G.S.W.S.-.G.-.B.P.B
-.-.S.-.-.-.-.-.B.P