10
-.-.G.G.-.-.-.-.-.-
-.-.G.G.-.-.-.S.-.-
-.-.-.-.-.-.BS.W.S.-
-.B.-.-.-.B.P.BS.-.B
B.P.B.G.-.-.B.-.B.P
-.B.-.-.G.-.-.-.-.B
-.-.-.-.-.G.G.G.G.-
-.G.A.G.-.-.G.G.G.-
S.-.-.-.S.-.G.G.G.B
W.S.-.S.W.S.-.-.B.P