10
P.B.-.-.G.-.-.-.-.-
B.-.-.G.-.-.G.-.G.-
-.G.-.-.G.-.-.-.-.-
-.-.S.-.G.-.-.B.-.-
-.S.W.S.A.-.B.P.B.-
-.-.S.-.-.G.-.B.-.-
-.-.G.-.S.-.-.G.-.-
G.-.-.S.W.S.-.-.S.-
-.-.-.-.S.-.-.S.P.S
-.-.G.-.-.-.G.-.SG.-