10
-.S.W.S.B.P.B.-.-.G
-.B.S.-.G.B.G.-.-.G
B.P.B.-.G.-.G.-.G.A
-.B.-.-.G.-.-.B.-.G
-.-.-.G.-.-.BSG.P.B.G
-.G.G.-.-.S.W.BSG.-.-
-.G.G.-.G.-.S.-.-.-
-.S.-.-.-.-.-.-.-.-
S.W.S.-.-.B.-.-.G.G
-.S.-.-.B.P.BS.-.G.G